11111101
10000001
10111111
10000001
10101011
10000011
11101001
10000001
11111101
10001001
10001011